RRRRRRRRRRRRRRRR
R..............R
R..............R
R.........R....R
R........RRR...R
R..............R
R..............R
R..............R
R..............R
R...........RRRR
R..............R
R..............R
R.........R....R
R.........R....R
R.........R....R
RRRRRRRRRRRRRRRR